1111111111111111
111100000C1E00C1
1001001100100001
10010C11C000C1C1
11C0011110C101P1
1100000C11110001
1111111111111111